###########
#         #
#### #### #
#B   #    #
# #### ####
#         #
#A#########
