###########
#         #
####B#### #
#    #    #
# #### ####
#         #
#A#########
