
#############################
#       #   B   #           #
# ### ### ######### ### ### #
#   #     #   #     # #     #
### ####### ### ##### # #####
#       #       #       #   #
### ### # ##### ######### ###
#     #   #     #   #       #
##### ### ### ### ### ##### #
#             A             #
#############################
