#######
#     #
## ## #
#B #  #
# ## ##
#    ##
#A#####
