##########
#       ##
# ## ## ##
# ## #####
# ##  ####
# ########
#    A   #
######## #
###    # #
###### # #
B#       #
##########
