########
#      #
#  B   #
#      #
#  A   #
#      #
########
