███████████
█         █
████ ████ █
█B   █    █
█ ████ ████
█         █
█A█████████

