###A###
#     #
# # # #
# # #B#
# # # #
# # # #
#######
