#######################
#        #   #        #
# ###### # # # ###### #
# #  B # # # # #    # #
# # #### # # # #### # #
# #      # # #      # #
# ########   ######## #
#   #    ## ##    #   #
### # ## ## ## ## # ###
#   # ##       ## #   #
# # # ########### # # #
# # #             # # #
#   ### ### ### ###   #
### ### ### ### ### ###
### ### ### ### ### ###
###                 ###
########### ###########
#        ## #         #
# ###### ## # ####### #
# ######### ######### #
#                     #
########### ###########
#          A          #
#######################
