XXXXBX
X    X
X XX X
X    X
XAXXXX
