####B#
#    #
# ## #
# ## #
#    #
#A####
