##A##
#   #
# # #
#   #
##B##
